######################
##.........#........##
#T..PK........X.....T#
##..................##
#....................#
######################
